{
  "maze": [
    ["#","#","#","#","#","#","#","#","#","#","#","#","#","#","#"],
    ["#"," "," "," ","#"," "," "," "," "," "," "," "," "," ","#"],
    ["#"," ","#"," ","#"," ","#","#","#","#","#"," ","#"," ","#"],
    ["#"," ","#"," "," ","T"," ","G","#","G"," "," ","#"," ","#"],
    ["#","#","#","#","#","T","#","#","#","#","#","#","#","#","#"],
    ["#"," "," "," "," "," "," "," ","#","G"," "," ","G"," ","#"],
    ["#"," ","#","#","#"," ","#","#","#"," ","#","#","#","#","#"],
    ["S"," ","#"," "," ","B","#"," ","#"," "," "," ","#"," ","#"],
    ["#"," ","#","#","#"," ","#"," ","#"," ","#"," ","#"," ","#"],
    ["#"," ","#","T"," "," "," "," ","T"," ","#"," "," "," ","#"],
    ["#"," ","#","#","#"," ","#","#","#","#","#"," ","#","#","#"],
    ["#"," ","#"," "," "," "," "," ","#"," "," "," "," "," ","#"],
    ["#","#","#","#","#"," ","#","#","#"," ","#","#","#"," ","#"],
    ["#"," "," "," "," "," "," "," ","#"," ","#"," "," "," ","#"],
    ["#","#","#","#","E","#","#","#","#","#","#","#","#","#","#"]
  ]
}