{
  "maze": [
    ["#","#","#","#","#","E","#"],
    ["#","T","T","B"," "," ","#"],
    ["#"," ","#"," ","#","#","#"],
    ["#"," ","#"," "," ","G","#"],
    ["#","G","#"," ","#","#","#"],
    ["#","T","#"," "," ","G","#"],
    ["#","#","#","#","S","#","#"]
  ]
}