{
  "maze": [
    ["#","#","#","#","#","#","#","#","#","#","#","#","#","#","#"],
    ["#","G","T"," ","T","G","#","G","T"," "," "," ","#"," ","#"],
    ["#","#","#"," ","#","#","#","#","#"," ","#"," ","#"," ","#"],
    ["#"," ","#"," ","#"," ","#","G","#"," ","#"," ","#","B","S"],
    ["#"," ","#"," ","#"," ","#","T","#"," ","#"," ","#"," ","#"],
    ["#"," "," "," "," "," "," "," "," ","T","#"," "," "," ","#"],
    ["#"," ","#"," ","#","#","#","#","#","#","#","#","#"," ","#"],
    ["#"," ","#"," "," "," ","#"," ","#","T","T"," "," "," ","#"],
    ["#"," ","#","#","#","#","#","G","#","#","#"," ","#"," ","#"],
    ["#","T"," "," "," ","G","#"," "," "," "," "," ","#"," ","#"],
    ["#","#","#","#","#","#","#","#","#","#","#","#","#","T","#"],
    ["#","T","#"," "," "," "," "," "," "," ","#"," ","T","T","#"],
    ["#","G","#"," ","#","T","#"," ","#"," ","#"," ","#"," ","#"],
    ["#"," "," "," ","#","G","#"," ","#","G"," "," ","#"," ","#"],
    ["#","#","#","#","#","#","#","#","#","#","#","#","#","E","#"]
  ]
}