{
  "maze": [
    ["#","#","#","#","#","#","#","#","#","#","#","#","#","#","#"],
    ["#"," "," "," ","#"," "," "," "," "," "," "," "," "," ","#"],
    ["#"," ","#"," ","#"," ","#","#","#","#","#"," ","#"," ","#"],
    ["#","G","#"," "," ","T","G","G","#","G"," "," ","#"," ","#"],
    ["#","#","#","#","#","T","#","#","#","#","#","#","#","#","#"],
    ["#"," "," "," "," "," "," "," ","#","G"," "," ","G"," ","#"],
    ["#"," ","#","#","#"," ","#","#","#"," ","#","#","#","#","#"],
    ["S","G","#"," "," "," ","#"," ","#"," "," "," ","#"," ","#"],
    ["#"," ","#","#","#"," ","#"," ","#"," ","#"," ","#"," ","#"],
    ["#"," ","#","T"," "," "," "," ","T"," ","#"," "," "," ","#"],
    ["#"," ","#","#","#"," ","#","#","#","#","#"," ","#","#","#"],
    ["#"," ","#"," "," "," "," "," ","#"," "," "," "," "," ","#"],
    ["#","#","#","#","#"," ","#","#","#"," ","#","#","#"," ","#"],
    ["#"," "," "," "," ","B"," "," ","#"," ","#"," "," "," ","#"],
    ["#","#","#","#","E","#","#","#","#","#","#","#","#","#","#"]
  ],
  "B": [26,28,16,28,21,20,22],
  "PlayerSkills": [[2,0],[12,6],[3,3]],
  "minRouds": 45,
  "CoinConsumption": 5
}