{
  "maze": [
    ["#","#","#","#","#","#","#","#","#","#","#","#","#","#","#"],
    ["#","G","T"," ","T","G","#","G","T"," "," "," ","#"," ","#"],
    ["#","#","#"," ","#","#","#","#","#"," ","#"," ","#"," ","#"],
    ["#"," ","#"," ","#"," ","#","G","#"," ","#"," ","#"," ","S"],
    ["#"," ","#"," ","#"," ","#","T","#"," ","#"," ","#"," ","#"],
    ["#"," "," "," "," "," "," "," "," ","T","#"," "," "," ","#"],
    ["#"," ","#"," ","#","#","#","#","#","#","#","#","#"," ","#"],
    ["#"," ","#"," "," "," ","#"," ","#","T","T"," "," "," ","#"],
    ["#"," ","#","#","#","#","#","G","#","#","#"," ","#","G","#"],
    ["#","T"," "," "," ","G","#"," "," "," "," "," ","#","G","#"],
    ["#","#","#","#","#","#","#","#","#","#","#","#","#","T","#"],
    ["#","T","#"," "," "," "," "," "," "," ","#"," ","T","T","#"],
    ["#","G","#"," ","#","T","#"," ","#"," ","#"," ","#"," ","#"],
    ["#"," "," "," ","#","G","#"," ","#","G"," "," ","#","B","#"],
    ["#","#","#","#","#","#","#","#","#","#","#","#","#","E","#"]
  ],
  "B": [29,14,20,18,16],
  "PlayerSkills": [[2,0],[12,4],[6,2]],
  "minRouds": 22,
  "CoinConsumption": 10
}